Darken33 - 24/01/2006

 *** DO NOT EDIT *** 

name=Antartic 1-3
width=25
height=20
bg=share/images/levels/level1-3_bg.jpg
timer=60
matrix
1,0,0,0,0,0,0,0,0,0,0,0,0,0,0,0,0,0,0,0,0,0,0,0,1,
1,0,0,0,0,0,0,0,0,0,0,0,0,0,0,0,0,0,0,0,0,0,0,0,1,
1,0,0,0,2,2,0,0,0,0,0,0,0,0,0,0,0,0,0,2,2,0,0,0,1,
1,0,0,0,0,0,0,0,0,0,0,0,0,0,0,0,0,0,0,0,0,0,0,0,1,
1,0,0,0,0,0,0,0,0,2,2,0,0,0,2,2,0,0,0,0,0,0,0,0,1,
1,0,0,0,3,3,0,0,0,0,0,0,0,0,0,0,0,0,0,3,3,0,0,0,1,
1,0,0,0,0,0,0,0,0,0,0,0,0,0,0,0,0,0,0,0,0,0,0,0,1,
1,2,2,0,0,0,2,2,0,0,0,0,0,0,0,0,0,2,2,0,0,0,2,2,1,
1,0,0,0,0,0,0,0,0,0,0,0,0,0,0,0,0,0,0,0,0,0,0,0,1,
1,0,0,0,0,0,0,0,0,0,0,3,3,3,0,0,0,0,0,0,0,0,0,0,1,
1,0,0,2,2,2,2,2,2,2,2,2,2,2,2,2,2,2,2,2,2,2,0,0,1,
1,0,0,0,0,0,0,0,0,0,0,0,0,0,0,0,0,0,0,0,0,0,0,0,1,
1,0,0,0,0,0,0,0,0,0,0,0,0,0,0,0,0,0,0,0,0,0,0,0,1,
1,0,0,0,0,0,0,0,0,0,1,1,1,1,1,0,0,0,0,0,0,0,0,0,1,
1,0,0,0,0,0,0,0,0,0,1,1,1,1,1,0,0,0,0,0,0,0,0,0,1,
1,0,0,0,0,0,0,0,1,1,1,1,1,1,1,1,1,0,0,0,0,0,0,0,1,
1,0,0,0,0,0,0,0,1,1,1,1,1,1,1,1,1,0,0,0,0,0,0,0,1,
1,0,0,0,0,0,1,1,1,1,1,1,1,1,1,1,1,1,1,0,0,0,0,0,1,
1,0,0,0,0,0,1,1,1,1,1,1,1,1,1,1,1,1,1,0,0,0,0,0,1,
1,1,1,1,1,1,1,1,1,1,1,1,1,1,1,1,1,1,1,1,1,1,1,1,1,
hero=tux:1:18:1:
enemies=xbill_0:4:9:1:,xbill_1:20:9:-1:,virus_0:4:13:1:,virus_1:20:13:-1:,virus_2:12:5:1:,
item=cdrom_0:4:1:40:40,cdrom_1:20:1:40:40,cdrom_2:12:12:40:40,cdrom_3:1:6:40:40,cdrom_4:23:6:40:40,fish_0:5:15:40:40,fish_1:19:15:40:40,fish_2:6:15:40:40,fish_3:18:15:40:40,fish_4:11:11:40:40,fish_5:12:11:40:40,fish_6:13:11:40:40,fish_7:7:6:40:40,fish_8:17:6:40:40,fish_9:12:3:40:40,fish_10:12:4:40:40,fish_11:12:5:40:40,
music=musique1.wav
EOF.